Columns: 30
Rows: 20
000000000000000000000000000000
000000000000000000000000000000
000000000000000000000000000000
000000000000000000000000000000
000000000000000000000000000000
000000000000000000000000000000
000000000000003434343434000000
000000000000005656565656000000
000000000000003400000000000000
000000000000005600000000000000
000000000000003400000000000000
000000000000005600000000000000
000000343434343400000000000000
000000565656565600000000000000
000000000000000000000000000000
000000000000000000000000000000
000000000000000000000000000000
000000000000000000000000000000
000000000000000000000000000000
000000000000000000000000000000
